24 24
22 22
1111  1111    1111    1111    2222    1111    1111    1111    2222    1111    1111    1111    2222    1111    1111    2222    1111    1111    1111    2222    1111    1111    1111    1111
1111  960000  960000  960000  960000  960000  960000  960000  960000  960000  960000  960000  960000  960000  960000  960000  960000  960000  960000  960000  960000  960000  960000  1111
1111  960000  960000  960000  960000  960000  960000  960000  960000  960000  960000  960000  960000  960000  960000  960000  960000  960000  960000  960000  960000  960000  960000  1111
2222  960000  960000  960000  960000  960000  960000  960000  960000  960000  960000  960000  960000  960000  960000  960000  960000  960000  960000  960000  960000  960000  960000  2222 
1111  960000  960000  960000  960000  960000  2223    3234    3234    3234    1232    960000  960000  960000  960000  1111    1B960000  1A960000    1B960000  1111    960000  960000  960000  1111
1111  960000  960000  960000  960000  960000  2223    1A220000  C220000  1A220000  1232    960000  960000  960000  960000  1A960000  960000  960000  960000  1A960000  960000  960000  960000  1111
1111  960000  960000  960000  960000  960000  2223    220000  220000  220000  1232    960000  960000  960000  960000  1111    960000  960000  960000  1111    960000  960000  960000  1111 
2222  960000  960000  960000  960000  960000  2223    220000  220000  220000  1232    960000  960000  960000  960000  960000  960000  960000  960000  960000  960000  960000  960000  2222
1111  960000  960000  960000  960000  960000  2223    2332    C110000  2323    2232    960000  960000  960000  960000  1B960000    960000  C960000    960000  1B960000    960000  960000  960000  1111
1111  960000  960000  960000  960000  960000  960000  960000  960000  960000  960000  960000  960000  960000  960000  960000  960000  960000  960000  960000  960000  960000  960000  1111 
2222  960000  960000  960000  960000  960000  960000  960000  960000  960000  960000  960000  960000  960000  960000  960000  960000  960000  960000  960000  960000  960000  960000  1111
1111  960000  960000  960000  960000  960000  960000  960000  960000  960000  960000  960000  960000  960000  960000  960000  960000  960000  960000  960000  960000  960000  960000  2222 
1111  960000  960000  960000  960000  960000  960000  960000  960000  960000  960000  960000  960000  960000  960000  960000  960000  960000  960000  960000  960000  960000  960000  1111
1111  960000  960000  960000  960000  960000  960000  960000  960000  960000  960000  960000  960000  960000  960000  960000  960000  960000  960000  960000  960000  960000  960000  1111
2222  960000  960000  960000  960000  960000  960000  960000  960000  960000  960000  960000  960000  960000  960000  960000  960000  960000  960000  960000  960000  960000  960000  1111 
1111  4444    4444    4444    4444    4444    4444    4444    4444    960000  960000  960000  960000  960000  960000  960000  960000  960000  960000  960000  960000  960000  960000  2222
1111  4444    460000  4444    460000  460000  460000  460000  4444    960000  960000  960000  960000  960000  960000  960000  960000  960000  960000  960000  960000  960000  960000  1111
1111  4444    460000  460000  460000  460000  8888    460000  4444    960000  960000  960000  960000  960000  960000  960000  960000  960000  960000  960000  960000  960000  960000  1111 
2222  4444    460000  4444    460000  460000  460000  460000  4444    960000  960000  960000  960000  960000  960000  960000  960000  960000  960000  960000  960000  960000  960000  1111
1111  4444    460000  4444    4444    4444    4444    4444    4444    960000  960000  960000  960000  960000  960000  960000  960000  960000  960000  960000  960000  960000  960000  2222
1111  4444    460000  460000  460000  460000  460000  460000  460000  960000  960000  960000  960000  960000  960000  960000  960000  960000  960000  960000  960000  960000  960000  1111 
1111  4444    4444    4444    4444    4444    4444    4444    4444    960000  960000  960000  960000  960000  960000  960000  960000  960000  960000  960000  960000  960000  960000  1111
1111  1111    1111    1111    2222    1111    1111    1111    2222    1111    1111    1111    2222    1111    1111    2222    1111    1111    1111    2222    1111    1111    1111    1111