24 24
12 22
1111  1111  1111  1111  9999  1111  1111  1111  9999  1111  1111  1111  9999  1111  1111  9999  1111  1111  1111  9999  1111  1111  1111  1111
1111  690000  690000  690000  690000  690000  690000  690000  690000  690000  690000  690000  690000  690000  690000  690000  690000  690000  690000  690000  690000  690000  690000  1111
1111  690000  690000  690000  690000  690000  690000  690000  690000  690000  690000  690000  690000  690000  690000  690000  690000  690000  690000  690000  690000  690000  690000  1111
9999  690000  690000  690000  690000  690000  690000  690000  690000  690000  690000  690000  690000  690000  690000  690000  690000  690000  690000  690000  690000  690000  690000  9999 
1111  690000  690000  690000  690000  690000  2223  3234  3234  3234  1232  690000  690000  690000  690000  3333  690000  5555  690000  3333  690000  690000  690000  1111
1111  690000  690000  690000  690000  690000  2223  690000  690000  690000  1232  690000  690000  690000  690000  690000  690000  690000  690000  690000  690000  690000  690000  1111
1111  690000  690000  690000  690000  690000  2223  690000  690000  690000  1232  690000  690000  690000  690000  1111  690000  690000  690000  1111  690000  690000  690000  1111 
9999  690000  690000  690000  690000  690000  2223  690000  690000  690000  1232  690000  690000  690000  690000  690000  690000  690000  690000  690000  690000  690000  690000  9999
1111  690000  690000  690000  690000  690000  2223  2332  690000  2323  2232  690000  690000  690000  690000  3333  690000  6666  690000  3333  690000  690000  690000  1111
1111  690000  690000  690000  690000  690000  690000  690000  690000  690000  690000  690000  690000  690000  690000  690000  690000  690000  690000  690000  690000  690000  690000  1111 
1111  690000  690000  690000  AB0000  AB0000  AB0000  AB0000  AB0000  AB0000  690000  690000  690000  690000  690000  690000  690000  690000  690000  690000  690000  690000  690000  1111
9999  690000  690000  690000  690000  690000  690000  690000  690000  690000  690000  690000  690000  690000  690000  690000  690000  690000  690000  690000  690000  690000  690000  1111
1111  690000  690000  690000  690000  690000  690000  690000  690000  690000  690000  690000  690000  690000  690000  690000  690000  690000  690000  690000  690000  690000  690000  9999 
1111  690000  690000  690000  690000  690000  690000  690000  690000  690000  690000  690000  690000  690000  690000  690000  690000  690000  690000  690000  690000  690000  690000  1111
1111  690000  690000  690000  690000  690000  690000  690000  690000  690000  690000  690000  690000  690000  690000  690000  690000  690000  690000  690000  690000  690000  690000  1111
9999  690000  690000  690000  690000  690000  690000  690000  690000  690000  690000  690000  690000  690000  690000  690000  690000  690000  690000  690000  690000  690000  690000  1111 
1111  4444  4444  4444  4444  4444  4444  4444  4444  690000  690000  690000  690000  690000  690000  690000  690000  690000  690000  690000  690000  690000  690000  9999
1111  4444  690000  4444  690000  690000  690000  690000  4444  690000  690000  690000  690000  690000  690000  690000  690000  690000  690000  690000  690000  690000  690000  1111
1111  4444  690000  690000  690000  690000  8888  690000  4444  690000  690000  690000  690000  690000  690000  690000  690000  690000  690000  690000  690000  690000  690000  1111 
9999  4444  690000  4444  690000  690000  690000  690000  4444  690000  690000  690000  690000  690000  690000  690000  690000  690000  690000  690000  690000  690000  690000  1111
1111  4444  690000  4444  4444  4444  4444  4444  4444  690000  690000  690000  690000  690000  690000  690000  690000  690000  690000  690000  690000  690000  690000  9999
1111  4444  690000  690000  690000  690000  690000  690000  690000  690000  690000  690000  690000  690000  690000  690000  690000  690000  690000  690000  690000  690000  690000  1111 
1111  4444  4444  4444  4444  4444  4444  4444  4444  690000  690000  690000  690000  690000  690000  690000  690000  690000  690000  690000  690000  690000  690000  1111
1111  1111  1111  1111  9999  1111  1111  1111  9999  1111  1111  1111  9999  1111  1111  9999  1111  1111  1111  9999  1111  1111  1111  1111