24 24
12 22
18 18 18 18 18 18 18 18 18 18 18 14 14 16 14 14 16 14 16 14 14 14 16 14
18 0  0  0  0  0  0  0  0  0  18 14 0  0  0  0  0  0  0  0  0  0  0  14
18 0  13 13 0  0  0  0  0  18 18 14 0  0  0  0  0  0  0  0  0  0  0  16
18 0  0  13 0  0  0  0  0  0  0  0  0  0  0  0  0  0  0  0  0  0  0  16
18 0  13 13 0  0  0  0  0  18 18 14 0  0  0  0  0  0  0  0  0  0  0  14
18 0  0  0  0  0  0  0  0  0  18 14 0  0  0  0  0  16 16 16 0  16 14 16
18 18 18 18 0  18 18 18 18 18 18 14 14 14 14 14 14 16 0  0  0  0  0  16
17 17 17 17 0  17 17 17 17 0  18 0  18 0  18 0  18 14 0  14 0  16 0  16
17 17 0  0  0  0  0  0  17 18 0  18 0  18 0  18 18 16 0  0  0  0  0  16
17 0  0  0  0  0  0  0  0  0  0  0  0  0  0  0  18 16 0  0  0  0  0  14
17 0  0  0  0  0  0  0  0  0  0  0  0  0  0  0  18 16 0  16 0  16 0  16
17 17 0  0  0  0  0  0  17 18 0  18 0  18 0  18 18 16 14 16 0  16 16 16
17 17 17 17 0  17 17 17 17 18 18 14 0  16 18 14 18 13 13 13 0  13 13 13
12 12 12 12 0  12 12 12 12 14 16 14 0  0  16 0  16 13 0  0  0  0  0  13
12 12 0  0  0  0  0  12 12 14 0  0  0  0  0  0  14 13 0  0  0  0  0  13
12 0  0  0  0  0  0  0  12 14 0  0  0  0  0  0  14 13 0  0  0  0  0  13
11 0  0  0  0  0  0  0  11 14 14 14 14 14 16 0  16 13 13 0  0  0  13 13
12 0  0  0  0  0  0  0  12 12 12 11 12 12 12 16 16 0  0  15 0  15 0  15
12 12 0  0  0  0  0  12 12 12 0  0  0  12 12 0  15 0  15 0  0  0  15 15
12 0  0  0  0  0  0  0  12 0  0  0  0  0  12 15 0  15 0  15 0  15 0  15
11 0  0  0  0  0  0  0  0  0  0  0  0  0  0  0  0  0  0  0  0  0  0  15
12 0  0  0  0  0  0  0  12 0  0  0  0  0  12 15 0  15 0  15 0  15 0  15
12 12 0  0  0  0  0  12 12 12 0  0  0  12 12 0  15 0  15 0  0  0  15 15
12 12 12 12 11 12 12 12 12 12 12 11 12 12 12 15 15 15 15 15 15 15 15 15