24 24
22 11
10 10 10 10 10 10 10 10 10 10 10 10 10 10 10 10 10 10 10 10 10 10 10 10
10 0 0 0 0 0 0 0 0 0 0 0 0 0 0 0 0 0 0 0 0 0 0 10
10 0 0 0 0 0 0 0 0 0 0 0 0 0 0 0 0 0 0 0 0 0 0 10
10 0 0 0 0 0 0 0 0 0 0 0 0 0 0 0 0 0 0 0 0 0 0 10
10 0 0 0 0 0 11 11 11 11 11 0 0 0 0 12 0 12 0 12 0 0 0 10
10 0 0 0 0 0 11 0 0 0 11 0 0 0 0 0 0 0 0 0 0 0 0 10
10 0 0 0 0 0 11 0 0 0 11 0 0 0 0 12 0 0 0 12 0 0 0 10
10 0 0 0 0 0 11 0 0 0 11 0 0 0 0 0 0 0 0 0 0 0 0 10
10 0 0 0 0 0 11 11 0 11 11 0 0 0 0 12 0 12 0 12 0 0 0 10
10 0 0 0 0 0 0 0 0 0 0 0 0 0 0 0 0 0 0 0 0 0 0 10
10 0 0 0 0 0 0 0 0 0 0 0 0 0 0 0 0 0 0 0 0 0 0 10
10 0 0 0 0 0 0 0 0 0 0 0 0 0 0 0 0 0 0 0 0 0 0 10
10 0 0 0 0 0 14 15 16 17 18 19 0 0 0 0 0 0 0 0 0 0 0 10
10 0 0 0 0 0 0 0 0 0 0 0 0 0 0 0 0 0 0 0 0 0 0 10
10 0 0 0 0 0 0 0 0 0 0 0 0 0 0 0 0 0 0 0 0 0 0 10
10 0 0 0 0 0 0 0 0 0 0 0 0 0 0 0 0 0 0 0 0 0 0 10
10 13 13 13 13 13 13 13 13 0 0 0 0 0 0 0 0 0 0 0 0 0 0 10
10 13 0 13 0 0 0 0 13 0 0 0 0 0 0 0 0 0 0 0 0 0 0 10
10 13 0 0 0 0 5 0 13 0 0 0 0 0 0 0 0 0 0 0 0 0 0 10
10 13 0 13 0 0 0 0 13 0 0 0 0 0 0 0 0 0 0 0 0 0 0 10
10 13 0 13 13 13 13 13 13 0 0 0 0 0 0 0 0 0 0 0 0 0 0 10
10 13 0 0 0 0 0 0 0 0 0 0 0 0 0 0 0 0 0 0 0 0 0 10
10 13 13 13 13 13 13 13 13 0 0 0 0 0 0 0 0 0 0 0 0 0 0 10
10 10 10 10 10 10 10 10 10 10 10 10 10 10 10 10 10 10 10 10 10 10 10 10