24 24
22 22
1111  1111    1111    1111    2222    1111    1111    1111    2222    1111    1111    1111    2222    1111    1111    2222    1111    1111    1111    2222    1111    1111    1111    1111
1111  960000  960000  960000  960000  960000  960000  960000  960000  960000  960000  960000  960000  960000  960000  960000  960000  960000  960000  960000  960000  960000  960000  1111
1111  960000  960000  960000  960000  960000  960000  960000  960000  960000  960000  960000  960000  960000  960000  960000  960000  960000  960000  960000  960000  960000  960000  1111
2222  960000  960000  960000  960000  960000  960000  960000  960000  960000  960000  960000  960000  960000  960000  960000  960000  960000  960000  960000  960000  960000  960000  2222 
1111  960000  960000  960000  960000  960000  960000  960000  960000  960000  960000  960000  960000  960000  960000  960000  960000  960000  960000  960000  960000  960000  960000  1111
1111  960000  960000  960000  960000  960000  960000  960000  960000  960000  960000  960000  960000  960000  960000  960000  960000  960000  960000  960000  960000  960000  960000  1111
1111  960000  960000  960000  960000  960000  960000  960000  960000  960000  960000  960000  960000  960000  960000  960000  960000  960000  960000  960000  960000  960000  960000  1111 
2222  960000  960000  960000  960000  960000  960000  960000  960000  960000  960000  960000  960000  960000  960000  960000  960000  960000  960000  960000  960000  960000  960000  2222
1111  960000  960000  960000  960000  960000  960000  960000  960000  960000  960000  960000  960000  960000  960000  960000  960000  960000  960000  960000  960000  960000  960000  1111
1111  960000  960000  960000  960000  960000  960000  960000  960000  960000  960000  960000  960000  960000  960000  960000  960000  960000  960000  960000  960000  960000  960000  1111 
2222  960000  960000  960000  960000  960000  960000  960000  960000  960000  960000  960000  960000  960000  960000  960000  960000  960000  960000  960000  960000  960000  960000  1111
1111  960000  960000  960000  960000  960000  960000  960000  960000  960000  960000  960000  960000  960000  960000  960000  960000  960000  960000  960000  960000  960000  960000  2222 
1111  960000  960000  960000  960000  960000  960000  960000  960000  960000  960000  960000  960000  960000  960000  960000  960000  960000  960000  960000  960000  960000  960000  1111
1111  960000  960000  960000  960000  960000  960000  960000  960000  960000  960000  960000  960000  960000  960000  960000  960000  960000  960000  960000  960000  960000  960000  1111
2222  960000  960000  960000  960000  960000  960000  960000  960000  960000  960000  960000  960000  960000  960000  960000  960000  960000  960000  960000  960000  960000  960000  1111 
1111  960000  960000  960000  960000  960000  960000  960000  960000  960000  960000  960000  960000  960000  960000  960000  960000  960000  960000  960000  960000  960000  960000  2222
1111  960000  960000  960000  960000  960000  960000  960000  960000  960000  960000  960000  960000  960000  960000  960000  960000  960000  960000  960000  960000  960000  960000  1111
1111  960000  960000  960000  960000  960000  960000  960000  960000  960000  960000  960000  960000  960000  960000  960000  960000  960000  960000  960000  960000  960000  960000  1111 
2222  960000  960000  960000  960000  960000  960000  960000  960000  960000  960000  960000  960000  960000  960000  960000  960000  960000  960000  960000  960000  960000  960000  1111
1111  960000  960000  960000  960000  960000  960000  960000  960000  960000  960000  960000  960000  960000  960000  960000  960000  960000  960000  960000  960000  960000  960000  2222
1111  960000  960000  960000  960000  960000  960000  960000  960000  960000  960000  960000  960000  960000  960000  960000  960000  960000  960000  960000  960000  960000  960000  1111 
1111  960000  960000  960000  960000  960000  960000  960000  960000  960000  960000  960000  960000  960000  960000  960000  960000  960000  960000  960000  960000  960000  960000  1111
1111  1111    1111    1111    2222    1111    1111    1111    2222    1111    1111    1111    2222    1111    1111    2222    1111    1111    1111    2222    1111    1111    1111    1111